▣▣▣▣▣▣▣▣▣▣▣▣▣▣▣▣▣▣▣▣▣▣▣▣▣▣▣▣▣▣▣▣▣▣▣▣▣▣▣▣▣▣▣▣▣▣▣▣▣▣▣▣▣▣▣▣▣▣▣▣▣▣▣▣▣▣▣▣▣▣▣▣▣▣▣▣▣▣▣▣
▣▣            ▣▣             ▣                 ▣   ▣▣     ▣      ▣   ▣   ▣    ▣▣
▣   ▣▣▣▣                     ▣                           ▣▣                    ▣
▣   ▣▣▣▣                  ▶                               ▣                    ▣
▣                            ▣             ♣              ▣                    ▣
▣♣♣♣♣♣      ◉◉◉              ▣             ♣                                   ▣
▣♣♣♣♣♣   ▣▣▣▣▣▣▣▣            ▣                            ▣                    ▣
▣♣♣♣♣♣   ▣       ▣           ▣                            ▣                    ▣
▣♣          ⚑    ▣           ▣                            ▣                    ▣
▣        ▣       ▣           ▣                            ▣                    ▣
▣ ☺      ▣▣▣▣▣▣▣▣▣           ▣                            ▣                    ▣
▣        ♣♣♣♣♣♣♣♣♣           ▣                            ▣                    ▣
▣   ◉    ▣▣▣▣▣▣▣▣▣▣▣▣▣▣▣▣▣▣▣▣▣                            ▣                    ▣
▣   ◉                        ▣                            ▣                    ▣
▣   ◉              ♣         ▣                ◉◉◉         ▣                    ▣
▣                            ▣                            ▣                    ▣
▣  ▣▣▣▣▣▣▣▣▣▣▣▣▣▣▣▣▣▣▣▣▣▣▣▣▣▣▣                            ▣                    ▣
▣  ▣           ▣             ▣                            ▣                    ▣
▣  ▣           ▣             ▣                            ▣                    ▣
▣  ▣           ▣             ▣                     ◉      ▣▣▣▣▣▣▣▣▣▣▣▣▣▣▣▣▣▣▣▣ ▣
▣  ▣           ▣             ▣                            ▣                    ▣
▣  ▣           ▣             ▣                            ▣                    ▣
▣  ▣           ▣             ▣                            ▣                    ▣
▣  ▣▣▣▣▣▣▣▣▣▣▣▣▣▣▣▣▣▣▣▣▣▣▣▣▣▣▣            ♣♣♣♣♣♣          ▣                    ▣
▣  ▣                         ▣             ♣♣♣♣           ▣                    ▣
▣  ▣                         ▣                            ▣                    ▣
▣  ▣                         ▣                            ▣                    ▣
▣  ▣                                                      ▣                    ▣
▣  ▣                         ▣                            ▣                 ★  ▣
▣▣▣▣▣▣▣▣▣▣▣▣▣▣▣▣▣▣▣▣▣▣▣▣▣▣▣▣▣▣▣▣▣▣▣▣▣▣▣▣▣▣▣▣▣▣▣▣▣▣▣▣▣▣▣▣▣▣▣▣▣▣▣▣▣▣▣▣▣▣▣▣▣▣▣▣▣▣▣▣