▣▣▣▣▣▣▣▣▣▣▣▣▣▣▣▣▣▣▣▣▣▣▣▣▣▣▣▣▣▣▣▣▣▣▣▣▣▣▣▣▣▣▣▣▣▣▣▣▣▣▣▣▣▣▣▣▣▣▣▣▣▣▣▣▣▣▣▣▣▣▣▣▣▣▣▣▣▣▣▣
▣▣            ▣▣             ▣                 ▣   ▣▣     ▣      ▣   ▣   ▣    ▣▣
▣   ▣▣▣▣                  ▶  ▣                           ▣▣                    ▣
▣   ▣▣▣▣                               ◉◉                 ▣                    ▣
▣                            ▣         ◉◉                 ▣                    ▣
▣♣♣♣♣♣     ◉◉◉◉◉◉            ▣                                                 ▣
▣♣♣♣♣♣   ▣▣▣▣▣▣▣▣▣           ▣                            ▣                    ▣
▣♣♣♣♣♣   ▣       ▣           ▣                            ▣                    ▣
▣           ⚑    ▣           ▣                            ▣                    ▣
▣        ▣       ▣           ▣                            ▣                    ▣
▣ ☺      ▣▣▣▣▣▣▣▣▣           ▣                            ▣                    ▣
▣        ♣♣♣♣♣♣♣♣♣           ▣     ♣♣♣♣♣♣♣♣♣♣♣♣           ▣                    ▣
▣        ▣▣▣▣▣▣▣▣▣▣▣▣▣▣▣▣▣▣▣▣▣                            ▣                    ▣
▣                            ▣                            ▣                    ▣
▣                  ♣         ▣                            ▣                    ▣
▣                            ▣                            ▣                    ▣
▣▣▣▣▣▣▣▣▣▣▣▣▣▣▣▣▣▣▣▣▣▣▣▣▣▣▣▣▣▣                            ▣                    ▣
▣  ▣           ▣             ▣                            ▣                    ▣
▣  ▣           ▣             ▣                            ▣                    ▣
▣  ▣           ▣             ▣                            ▣▣▣▣▣▣▣▣▣▣▣▣▣▣▣▣▣▣▣▣▣▣
▣  ▣           ▣             ▣                            ▣                    ▣
▣  ▣           ▣             ▣                            ▣                    ▣
▣  ▣           ▣             ▣                            ▣                    ▣
▣  ▣▣▣▣▣▣▣▣▣▣▣▣▣▣▣▣▣▣▣▣▣▣▣▣▣▣▣            ♣♣♣♣♣♣          ▣                    ▣
▣  ▣                         ▣             ♣♣♣♣           ▣                    ▣
▣  ▣                         ▣                            ▣                    ▣
▣  ▣                         ▣                            ▣                    ▣
▣  ▣                                                      ▣                    ▣
▣  ▣                         ▣                            ▣                 ★  ▣
▣▣▣▣▣▣▣▣▣▣▣▣▣▣▣▣▣▣▣▣▣▣▣▣▣▣▣▣▣▣▣▣▣▣▣▣▣▣▣▣▣▣▣▣▣▣▣▣▣▣▣▣▣▣▣▣▣▣▣▣▣▣▣▣▣▣▣▣▣▣▣▣▣▣▣▣▣▣▣▣