▣▣▣▣▣▣▣▣▣▣▣▣▣▣▣▣▣▣▣▣▣▣▣▣▣▣▣▣▣▣▣▣▣▣▣▣▣▣▣▣▣▣▣▣▣▣▣▣▣▣▣▣▣▣▣▣▣▣▣▣▣▣▣▣▣▣▣▣▣▣▣▣▣▣▣▣▣▣▣▣
▣▣            ▣▣             ▣                 ▣   ▣▣     ▣      ▣   ▣   ▣    ▣▣
▣   ▣▣▣▣                  ▶  ▣                           ▣▣                    ▣
▣   ▣▣▣▣                               ◉◉                 ▣                    ▣
▣                            ▣         ◉◉                 ▣                    ▣
▣♣♣♣♣♣      ◉◉◉              ▣                                                 ▣
▣♣♣♣♣♣   ▣▣▣▣▣▣▣▣            ▣                            ▣                    ▣
▣♣♣♣♣♣   ▣       ▣           ▣                            ▣                    ▣
▣♣          ⚑    ▣           ▣                            ▣                    ▣
▣        ▣       ▣           ▣                            ▣                    ▣
▣ ☺      ▣▣▣▣▣▣▣▣▣           ▣                            ▣                    ▣
▣        ♣♣♣♣♣♣♣♣♣           ▣                            ▣                    ▣
▣   ◉    ▣▣▣▣▣▣▣▣▣▣▣▣▣▣▣▣▣▣▣▣▣                            ▣                    ▣
▣   ◉                        ▣                            ▣                    ▣
▣   ◉              ♣         ▣                            ▣                    ▣
▣                            ▣                            ▣                    ▣
▣▣▣▣▣▣▣▣▣▣▣▣▣▣▣▣▣▣▣▣▣▣▣▣▣▣▣▣▣▣                            ▣                    ▣
▣  ▣           ▣             ▣                            ▣                    ▣
▣  ▣           ▣             ▣                            ▣                    ▣
▣  ▣           ▣             ▣                            ▣▣▣▣▣▣▣▣▣▣▣▣▣▣▣▣▣▣▣▣▣▣
▣  ▣           ▣             ▣                            ▣                    ▣
▣  ▣           ▣             ▣                            ▣                    ▣
▣  ▣           ▣             ▣                            ▣                    ▣
▣  ▣▣▣▣▣▣▣▣▣▣▣▣▣▣▣▣▣▣▣▣▣▣▣▣▣▣▣            ♣♣♣♣♣♣          ▣                    ▣
▣  ▣                         ▣             ♣♣♣♣           ▣                    ▣
▣  ▣                         ▣                            ▣                    ▣
▣  ▣                         ▣                            ▣                    ▣
▣  ▣                                                      ▣                    ▣
▣  ▣                         ▣                            ▣                 ★  ▣
▣▣▣▣▣▣▣▣▣▣▣▣▣▣▣▣▣▣▣▣▣▣▣▣▣▣▣▣▣▣▣▣▣▣▣▣▣▣▣▣▣▣▣▣▣▣▣▣▣▣▣▣▣▣▣▣▣▣▣▣▣▣▣▣▣▣▣▣▣▣▣▣▣▣▣▣▣▣▣▣